1111111111111111111111111111111111111111
1P00001000000000010000000001000000000001
101101011111110101011111101011111111101
101C010000M001010001000010001000C000101
101111111110010111110110111110111110101
100000000010010000000110000000100000101
111110111010111111110111111101011111101
1000001C101000000000000000000101C000001
101111101011111111011111111111011111101
1010000010000000M1010000000000000000101
101011111111111001010111111111111110101
101010000000001001010100000000000010101
10001011111100101101010111111111010101
1110101C000100100001010100000001010101
10001011100100111111010101111001000101
10111000100100000000000101C01001111101
10001110100111111111111101101000000001
11100010100000000000000000001111111101
10110010111111111111111111111000000101
100110100000000000M000000000001110101
1100101111111111111111111111101C10101
1010100000000000000000000000001010101
1010111111111111111111111111111010101
11100000000000000000000000000000000E1
1111111111111111111111111111111111111111