1111111111111111111111111111111111111111
1P00000000100000000000010000000000000001
1011111100100111111110010011111111111001
1010000100000100000010000010000000001001
1010C00111110101110011111010111111001001
1010000000000101C10000000000100000001001
1011111111110101110111111111101111011001
1000000000000000000100000000001000000001
1011111011111111100101111111101011111101
1010000010000000100101000000001010000101
1010111010111100100001011111101010100101
10101C1000100000111111010000100010100101
1000111011101110000000010000111110100101
1010000000000001110111011110000000100101
1011111111111001C101C1000011111111100101
1000000000001001110111010000000000000101
1111110111001000000000010111111111111101
1000000101001111110111110100000000000001
1011110101000000010100000001111111111001
101C000101111110010101111111000000001001
1011110100000010010001000000011111011001
1000100111110010M1010111111101C000010001
1110100000000011110101000000011111010111
1E00001111110000000000011111000000000001
1111111111111111111111111111111111111111