1111111111111111111111111111111111111111
1P00000000000010000000000001000000000001
1011110111110101111101111010111110111101
10C0000100000100000100000100000100000C1
1010111101111101111101111101111101110101
1000000001000000000000000001000000000001
1110111111011110111110111111011110111101
1000100000010000000100000000010000100001
1011101111010111110101111111010111011101
10C0000000010000000000000000010000000C1
1011111111011110111110111111011111111101
10000000010000001000M0100000100000000001
1011111101111101111101111101111110111101
1000000100000000000000000000000100000001
1011110111110111110101111111011110111101
1000000000000000000000000000000000000001
1011110111110101111101111010111110111101
10C0000100000100000100000100000100000C1
1010111101111101111101111101111101110101
1000000001000000000000000001000000000001
1110111111011110111110111111011110111101
10001000000100000001000M0000001000010001
1011101111010111110101111111010111011101
1000000000000000000000000000000000000001
1E00000000000000000000000000000000000001
1111111111111111111111111111111111111111
# This was done by AI: Gemini used
# 