1111111111111111111111111111111111111111
1P00000000000000000000000000000000000001
1000111100000111100000011110000011110001
1000111100000111100000011110000011110001
10C0000000B000000000000000000B0000000C1
1000111100000111100000011110000011110001
1000111100000111100000011110000011110001
1000000000000000000000000000000000000001
1000000000000000000000000000000000000001
1000111100000000000M00000000000011110001
1000111100000000000000000000000011110001
10C0000000000000000C00000000000000000C1
1000111100000000000000000000000011110001
1000111100000000000000000000000011110001
1000000000000000000000000000000000000001
1000000000000000000000000000000000000001
1000111100000111100000011110000011110001
1000111100000111100000011110000011110001
10C0000000B000000000000000000B0000000C1
1000111100000111100000011110000011110001
1000111100000111100000011110000011110001
1000000000000000000000000000000000000001
1000000000000000000000000000000000000001
1E00000000000000000000000000000000000001
1111111111111111111111111111111111111111

# This was done by AI: Gemini used
# 