1111111111111111111111111111111111111111 
1P00000000000000000000000000000000000001
1001001001001001001001001001001001001001
10C000000000C00000000000000000C0000000C1
1001001001001001001001001001001001001001
1000000000000000000000000000000000000001
1001001001001001001001001001001001001001
1000000000000000000000000000000000000001
1001001001001001001001001001001001001001
10C00000000000000000M00000000000000000C1
1001001001001001001001001001001001001001
1000000000000000100000000000000000000001
1001001001001001001001001001001001001001
1000000000000000000000000000000000000001
1001001001001001001001001001001001001001
10C00000000000000000000000000000000000C1
1001001001001001001001001001001001001001
1000000000000000000000000000000000000001
1001001001001001001001001001001001001001
1000000000000000000000000000000000000001
1001001001001001001001001001001001001001
10C000000000C00000000000000000C0000000C1
1001001001001001001001001001001001001001
1E00000000000000000000000000000000000001
1111111111111111111111111111111111111111 

