1111111111111111111111111111111111111111
1P00000000010000000000000000010000000001
1011111110010011111111111100100111111101
101C00000001000000000000000001000000C101
101011111111111111000011111111111110101
100000000001000000000000000001000000001
1011111110010011111111111100100111111101
1000000000000000000000000000000000000001
1011111111111111110000111111111111111101
10C00000000000000000M0000000000000000C1
1011111111111111110000111111111111111101
1000000000000000000000000000000000000001
1011111110010011111111111100100111111101
100000000001000000000000000001000000001
101011111111111111000011111111111110101
101C00000001000000000000000001000000C101
1011111110010011111111111100100111111101
1000000000000000000000000000000000000001
1011111111111111110000111111111111111101
10C0000000000000000000000000000000000C1
1011111111111111110000111111111111111101
1000000000000000000000000000000000000001
1011111111111111111111111111111111111101
1E00000000000000000000000000000000000001
1111111111111111111111111111111111111111