1111111111111111111111111111111111111111
1P00000000000000000000000000000000000001
1000000000000000000000000000000000000001
1001111111100000000000000000111111110001
1001111111100000000000000000111111110001
1000000000000000000000000000000000000001
1000000000000000000000000000000000000001
1000000000001111111111110000000000000001
10E10000000011111111111100000000000E1001
1000000000001111111111110000000000000001
10000C00000000000000000000000000C0000001
10000000000000000M0000000000000000000001
1000000000000000000000000000000000000001
10000C00000000000000000000000000C0000001
10E1000000001111111111110000000000000001
1000000000001111111111110000000000000001
1000000000001111111111110000000000000001
1000000000000000000000000000000000000001
1000000000000000000000000000000000000001
1001111111100000000000000000111111110001
1001111111100000000000000000111111110001
1000000000000000000000000000000000000001
1000000000000000000000000000000000000001
1000000000000000000000000000000000000001
1111111111111111111111111111111111111111

# This was done by AI map: Grok was used.
# Need to fix this map
