1111111111111111111111111111111111111111
1P00000000000000111110000000000000000001
1011111111111100010001111111111111111101
10C0000000000100010001000000000000000C1
10101111111001000100010011111111010101
10001000001000000100000010000001000101
10111011101111110111111011101110111001
1000001000000000000T000000010000000001
10111010111101111111111011110101110101
10B00010000001000000001000000100000B01
10111110111111011111101111110111111001
10C00000000000010000010000000000000C01
10101111111111010111010111111111101001
100000000000010001M0010000000000000001
10111111111001000100010011111111111001
10000000001000000100000010000000000001
10111111101111110111111011111111111001
10C00000000000000000000000000000000C01
10101111111111011111101111111111101001
10C00000000001000000001000000000000C01
10111111111001000100010011111111111001
10000000001000000100000010000000000001
10101111111111111111111111111111101001
1000000000000000000T000000000000000001
1E0000000000000000000000000000000000001
1111111111111111111111111111111111111111
