1111111111111111111111111111111111111111
1P00000000000000000000000000000000000001
1000111100000000000000000000000011110001
10C0111100000111100000011110000011110C01
1000000000B001111000000111100B0000000001
10000000X000000000000X000000000000000001
1000111100000000000000000000000011110001
1000111100000000000000000000000011110001
1000000000000000000000000000000000000001
1000000000000000000M00000000000X0000001
1001100000000000000000000000000000011001
10C1100000000000000C00000000000000011C01
1001100000000000000000000000000000011001
10000000000000X00000000000000000000001
1000000000000000000000000000000000000001
1000111100000000000000000000000011110001
1000111100000000000000000000000011110001
1000000000000000000000000000000000000001
1000000000B001111000000111100B0000000001
10C0111100000111100000011110000011110C01
1000111100000000000000000000000011110001
100000000000000000000000000000000X000001
1000000000000000000000000000000000000001
1E00000000000000000000000000000000000001
1111111111111111111111111111111111111111
# This was done by AI map: Gemini used.
