111111111111111
1P0000000000001
101110111011101
10C000M00000001
101110111011101
1000000000000E1
111111111111111